16 16
1 1 1 1 1 1 1 1 1 1 1 1 1 1 1 1
1 0 0 0 0 0 0 0 0 0 0 0 0 0 0 1
1 0 2 2 2 0 0 0 0 0 0 3 3 3 0 1
1 0 2 2 2 0 0 0 0 0 0 3 3 3 0 1
1 0 2 2 2 0 0 4 4 0 0 3 3 3 0 1
1 0 0 0 0 0 0 4 4 0 0 0 0 0 0 1
1 0 0 5 5 0 0 0 0 0 0 5 5 0 0 1
1 0 0 5 5 0 0 0 0 0 0 5 5 0 0 1
1 0 0 0 0 0 4 4 0 0 0 0 0 0 0 1
1 0 2 2 2 0 4 4 0 0 3 3 3 0 0 1
1 0 2 2 2 0 0 0 0 0 3 3 3 0 0 1
1 0 2 2 2 0 0 0 0 0 3 3 3 0 0 1
1 0 0 0 0 0 0 0 0 0 0 0 0 0 0 1
1 1 1 1 1 1 1 1 1 1 1 1 1 1 1 1

// Map Legend:
// 0: Path/Lane
// 1: Map Border
// 2: Top Lane (Blue Side)
// 3: Top Lane (Red Side)
// 4: Mid Lane
// 5: Bottom Lane